F                                                            f                                     I
HF                                                                                                 I
AHF                   g               EBBF       I   h             I      e  b   III               I
AAHF                    i     EBBBBBBBGAAD       i                           III          i          I
AAAHF                        EGAAAAAAAAAAD               II           III             I          * I
AAAAHBBBBBBBBBBBBBBBBBBBBBBBBGAAAAAAAAAAAHBBBBBBBBBB   II  II    III                      I   I  III
