# Map file for tile-based game
# (Lines that start with '#' are comments)
# The tiles are:
#   (Space) Empty tile
#   A..Z    Tiles A through Z
#   !       Music Note
#   *       Goal
#   ^	    Health
#   a       Bad Guy a (grub)
#   b       Bad Guy b (fly)
#   c       Bad Guy c (monkey)
#   d	    Boss Guy 
#   0       Warp
#   +       Brain (like health)
#   @       Book (like star)
                                                                 
                                                                 
AD                                                        b              b                     
AD                      @ @ @                                   bIIIIII  EBBBBBBBF c        @                       EF
AD c                   IIIIIII                  c      IIII              CAAAAAAAD    @                c            CD
AD                    b   !        b    a       a          b             CAAAAAAAAF        c                        CD
AD              a       IIIII                IIIII                       CAAAAAAAAHF   IIIIIII                      CD
AD          III                          a  b          b                 CAAAAAAAAAD b           c          c       CD
AD                            a      IIII                                CAAAAAAAAAHF @                             CD
AD  c   a       EBBBF      c          @ @ @ @ @ @                        CAAAAAAAAAAD  @          bEBBBF   a  b  d  CD
AHBBBBBBBBBBBBBBGAAAHBBBBBBBBBBBBBBBBBBBF                                EBGAAAAAAAAAAHBBBBBBBBBBBBBBBGAAAHBBBBBBBBBBB