# Map file for tile-based game
# (Lines that start with '#' are comments)
# The tiles are:
#   (Space) Empty tile
#   A..Z    Tiles A through Z
#   !       Music Note
#   *       Goal
#   ^	    Health
#   a       Bad Guy a (grub)
#   b       Bad Guy b (fly)
#   c       Bad Guy c (monkey)
#   d	    Boss Guy 
#   e		Bad Guy (sinuousfly)
#   f		Bad Guy (homingfly)
#   g		Bad Guy (randomfly)
#   0       Warp
#   +       Brain (like health)
#   @       Book (like star)


BF          @ @ @                @ @ @ @ @ @ @ @ @ @ @ @ @ @ @ @ @ @ @ @ @ @ @                EB
AD         IIIIIII              IIIIIIIIIIIIIIIIIIIIIIIIIIIIIIIIIIIIIIIIIIIIIII               CA
AD                      @ @ @                I                   EBBBBBBBBBBBBBF     @ @ @ @  CA
AD                     IIIIIII               I                   CAAAAAAAAAAAAAD    @ @ @ @ @ CA
AD                    b   !        b                      IIIII  CAAAAAAAAAAAAAAD   @ @ @ @ @ CA
AD                      IIIII                                    CAAAAAAAAAAAAAAHF   IIIIIII  CA
AD         III                          a    a  a        b       CAAAAAAAAAAAAAAAD  @ @ @ @ @ CA
AD                            a      IIIIIIIIIIIII               CAAAAAAAAAAAAAAAHF  @ @ @ @  CA
AD      a       EBBBBBBBBBBBBBBBF     @ @ @ @ @ @              * CAAAAAAAAAAAAAAAAD @ @ @ @ @ CA
AHBBBBBBBBBBBBBBGAAAAAAAAAAAAAAAHBBBBBBBBBBBBBBBBBBBBBBBBBBBBBBBBGAAAAAAAAAAAAAAAAHBBBBBBBBBBBGA